1111111111111111111111111111111111111211111111111111111111111
1000000000000000100000000000000000101000001000001000001000001
1011111111111110101111111111111010101111101011101110101011101
1010000010000000101000000000001010100000101010000000101010001
1010111010111111101011111111111010111010101011111111101010111
1010001010000000101000001000000010000010101000100000001010001
1010101111111110101011101011111011111111101110101111111011111
1010101000000000101000101010001010000000101000100000000010001
1010101011111110101011101010101010111110101010111111111110101
1010101010000010101010001010101010100010101010100000000000101
1011101010101110101010111010101010101010101010101111111111101
0000001010101000101010001010101010101010001010100010000000101
1111111010111011101011101010101010101011111010111010111110101
1000000010100010001010101010100010101010000010101010100010101
1011111110101110111010101011111110101110111010101010101011101
1010000000100010100010101000000000100000001010101010101010001
1010111110111010101110101111111111111111111010101010101010101
1010000010001010100000100000000000000000001010001000101000101
1011111110111010111111101111111111111111101011111110101111101
1000000010001010000000001000100000000000101000000000101000101
1011111010101011111111111010101111111110101111111111101010101
1010001010100000100000000010101000100000101000000000001010101
1011101011111111101111101110101010101110101011111111111010101
1010001000000000101000101000100010101010101000000000001010101
1010111111111110101010101011111111101010101011111111101010101
1010000000000010101010101010000000001000101000100000001010101
1011111011111010101010101010111111111011101111101111111011101
1000000010000010101010101010101000001010101000001000100000101
1111101111111110101011101010101010101010101011111010101110101
1000001000000010101000101010101010101000100010000010100010001
1011111011111010101110101010101010111110111110111010111011111
1010001010001010100010101010101010000000000010100010001010001
1010111010101010111010101010101011111111111110101111111010111
1010100010101010000000101000101010000010000000100000000010001
1010101110111011111111101111101010111010111111111111111111101
1010101000000000000000001000000010001010100000000000100000001
1010101111111111111111111111111010111010101111111110101011101
1000101000000000000000000000001010100010101000000000101010101
1111101011111111111111111111101010101110101011111111111010101
1000001000000010100000100000101010100010001010000000000010101
1011101111111010101010111110101010111011111011111011111110101
1010101000001010101010000000101010101000001000001000000010101
1010101011101010101011111110101010101011101111101111111010101
1010001010101010101010000010101010001010000000100000000010001
1010111010101010101010111010101011111011111111111111111110111
1010001010100010001010101010101000000010000000000000000010101
1011111010111111101010101010101111111010111111111111111010101
1000000010100000101010101010101000001010001000000000100010101
1011111110101010101010101010101011111011101010111111101010101
1010001000101010101010101010101000000000101010001000001010101
1010101011101010101010101010101011111110101111101011111010101
1010101000001010101010101010101000100010101000001010001010101
1010101111111010101010101010101111101010101011101010101010101
1010100000000010101010001000100000001010101010101010101010101
1010111111111110111010111111111111101010101010101010101010101
1010100010001010100010100000000000101010101010001010101010101
1010101010101010101110101111111110111010101011111010101010101
1010101000100010101000101000000000000010101010000010100010101
1010101111111110101011101111111111111111101010111111111110101
1000100000000000001000100000000000000000000010000000000000001
1111111111111111111111111111111111111111111111111111111111111