1111111111111111111111111111111111111011111111111111111111111
1000000000000000100000000000000000101000001000001000001000001
1011111111111110101111111111111010101111101011101110101011101
1010000010000000101000000000001010100000101010000000101010001
1010111010111111101011111111111010111010101011111111101010111
1010001010000000101000001000000010000010101000100000001010001
1010101111111110101011101011111011111111101110101111111011111
1010101000000000101000101010001010100000101000100000000010001
1010101011111110101011101010101010111110101010111111111110101
1010101010000010101010001010101010100010101010100000000000101
1011101010101110101010111010101010101010101010101111111111101
0000001010101000101010001010101010101010001010100010000000101