11111111
10010011
11010111
11011110
11010110
11010110
10010011
10101111