11111111111111111111111
10000000001000000010101
11111110101011111110101
00000000100010000000101
11111010111111101110101
10000010000010000010101
10111011111110111011101
10001010100000101010001
10111010101111101010111
10100000101010000000101
10101111101010101110101
10101000000010100010101
11101011111010111011101
10001010001010101000001
10101011101110101111111
10101000101000001000001
10101110101011111011101
10100000101010100010001
10101111101010101111111
10101000100010000000002
10101011111011101011111
10100010000000001000001
11111111111111111111111